5 5 5 5 5 5 5 5 5 5 5 5 5
5 0 0 1 0 0 0 1 0 0 0 0 5
5 0 0 2 0 0 4 1 0 0 0 0 5
5 0 1 1 1 1 0 1 0 1 0 2 5
5 0 0 0 0 0 0 0 0 1 0 0 5
5 0 1 1 0 1 0 1 1 1 0 0 5
5 0 1 0 0 0 0 1 0 0 0 0 5
5 0 1 1 0 1 1 1 2 1 0 0 5
5 0 0 1 0 2 0 1 0 1 0 0 5
5 0 0 1 0 0 0 1 0 0 0 0 5
5 3 0 1 1 1 0 1 1 1 0 1 5
5 0 0 0 0 0 0 0 0 0 0 0 5
5 5 5 5 5 5 5 5 5 5 5 5 5